00000000000000000000
00000000000000000000
00000000000000000000
00000111110000000000
00011122510000000000
00012234210000000000
00012243421000000000
00011229321000000000
00000122221000000000
00000111110000000000
00000000000000000000
00000000000000000000
00000000000000000000
00000000000000000000
00000000000000000000
00000000000000000000
00000000000000000000
00000000000000000000
00000000000000000000
00000000000000000000
