00000000000000000000
00000000000000000000
00001111110000000000
00001244410000000000
01111444410000000000
01221113211100000000
01232322332100000000
01523232222100000000
01222111222100000000
01111101111100000000
00000000000000000000
00000000000000000000
00000000000000000000
00000000000000000000
00000000000000000000
00000000000000000000
00000000000000000000
00000000000000000000
00000000000000000000
00000000000000000000