00000000000000000000
00000000000000000000
00000111111100000000
00001122125100000000
00001222132100000000
00001322322100000000
00001231122100000000
00111232121100000000
00144444221000000000
00111111111000000000
00000000000000000000
00000000000000000000
00000000000000000000
00000000000000000000
00000000000000000000
00000000000000000000
00000000000000000000
00000000000000000000
00000000000000000000
00000000000000000000