00000000000000000000
00000000000000000000
00000000000000000000
00000111111000000000
00011122221000000000
00114231121100000000
00144323225100000000
00144232321100000000
00111111221000000000
00000001111000000000
00000000000000000000
00000000000000000000
00000000000000000000
00000000000000000000
00000000000000000000
00000000000000000000
00000000000000000000
00000000000000000000
00000000000000000000
00000000000000000000
