00000000000000000000
00000000000000000000
00111111111000000000
00122112221000000000
00122232221000000000
00132111231000000000
00121444121000000000
01121444121100000000
01232232232100000000
01222221225100000000
01111111111100000000
00000000000000000000
00000000000000000000
00000000000000000000
00000000000000000000
00000000000000000000
00000000000000000000
00000000000000000000
00000000000000000000
00000000000000000000