00000000000000000000
00000000000000000000
00000000000000000000
00000111111000000000
00000122221000000000
00011133321000000000
00015234421000000000
00012344411000000000
00011112210000000000
00000011110000000000
00000000000000000000
00000000000000000000
00000000000000000000
00000000000000000000
00000000000000000000
00000000000000000000
00000000000000000000
00000000000000000000
00000000000000000000
00000000000000000000